cellID	celltype
AAACCTGAGACCACGA.1	CD8+T cell
AAACCTGAGTCGAGTG.1	naïve B cells
AAACCTGGTGTTTGTG.1	CD8+T cell
AAACCTGTCACCAGGC.1	CD4+T cell
AAACGGGCAGGCTCAC.1	CD8+T cell
AAACGGGGTCTAGTCA.1	CD4+T cell
AAAGATGAGCGTTGCC.1	CD4+T cell
AAAGATGAGTGTTGAA.1	NK cell
AAAGATGCAGTGACAG.1	classical monocytes
AAAGCAACACAAGCCC.1	CD4+T cell
AAAGCAACACCTTGTC.1	classical monocytes
AAAGCAATCGGTGTCG.1	CD8+T cell
AAAGTAGAGTTTAGGA.1	CD8+T cell
AAAGTAGCATCCGGGT.1	CD4+T cell
AAAGTAGCATGCAATC.1	CD4+T cell
AAAGTAGGTATATCCG.1	CD4+T cell
AAAGTAGGTCGACTGC.1	CD8+T cell
AAATGCCGTCCTCTTG.1	classical monocytes
AACACGTAGACGCACA.1	NK cell
AACACGTGTCGCCATG.1	CD4+T cell
AACACGTTCCTCATTA.1	NK cell
AACCATGGTACTCTCC.1	classical monocytes
AACCATGGTCGGCATC.1	CD4+T cell
AACCATGGTGCGGTAA.1	CD4+T cell
AACCGCGTCAACACAC.1	CD4+T cell
AACGTTGTCCAATGGT.1	CD4+T cell
AACTCAGCAGTCTTCC.1	CD4+T cell
AACTCAGCATTAGCCA.1	CD4+T cell
AACTCAGGTTAGATGA.1	CD8+T cell
AACTCAGTCAGCACAT.1	NK cell
AACTCTTCACCAGCAC.1	CD4+T cell
AACTCTTCACCAGGTC.1	classical monocytes
AACTCTTCAGATGGCA.1	CD8+T cell
AACTCTTTCAGTGCAT.1	CD4+T cell
AACTCTTTCTGATTCT.1	CD4+T cell
AACTGGTAGGCTCATT.1	CD4+T cell
AACTTTCAGGTAGCCA.1	naïve B cells
AACTTTCAGGTGCTAG.1	CD4+T cell
AACTTTCCACCAGATT.1	CD4+T cell
AACTTTCCACCTCGGA.1	classical monocytes
AAGACCTCACGGCCAT.1	CD4+T cell
AAGACCTCAGCTCGAC.1	NK cell
AAGACCTGTTAGAACA.1	NK cell
AAGCCGCAGGATGTAT.1	classical monocytes
AAGCCGCAGGTCATCT.1	classical monocytes
AAGCCGCAGTACTTGC.1	CD8+T cell
AAGCCGCCAATGAATG.1	CD4+T cell
AAGGAGCAGGCTCATT.1	CD4+T cell
AAGGAGCCATGGTTGT.1	CD4+T cell
AAGGAGCGTTTGTTTC.1	CD8+T cell
AAGGCAGAGCGATCCC.1	CD4+T cell
AAGGCAGGTTCAACCA.1	CD8+T cell
AAGGCAGTCAGAGCTT.1	CD4+T cell
AAGGCAGTCGCGGATC.1	CD4+T cell
AAGGTTCAGAAGATTC.1	NK cell
AAGGTTCTCCGCATAA.1	CD8+T cell
AAGTCTGAGGATGGAA.1	CD4+T cell
AAGTCTGCACGGCGTT.1	NK cell
AAGTCTGTCAAGAAGT.1	CD4+T cell
AAGTCTGTCAGTACGT.1	CD4+T cell
AAGTCTGTCTACTATC.1	NK cell
AAGTCTGTCTCGCATC.1	CD4+T cell
AATCCAGGTGCCTTGG.1	classical monocytes
AATCCAGGTTGGAGGT.1	NK cell
AATCGGTGTCTGGTCG.1	NK cell
AATCGGTGTTCCGTCT.1	CD4+T cell
AATCGGTTCCTGTACC.1	NK cell
ACACCAAAGCTGCGAA.1	CD4+T cell
ACACCGGCATGTCCTC.1	CD4+T cell
ACACCGGGTCGCGTGT.1	classical monocytes
ACATACGCACAACGCC.1	CD8+T cell
ACATACGTCTTGCCGT.1	CD4+T cell
ACATACGTCTTGTTTG.1	CD8+T cell
ACATCAGAGACAATAC.1	CD4+T cell
ACATGGTTCGTCCAGG.1	CD8+T cell
ACCAGTAAGGCGCTCT.1	classical monocytes
ACCCACTAGTCGTTTG.1	NK cell
ACCCACTGTTAAGAAC.1	CD4+T cell
ACCCACTTCAACACTG.1	NK cell
ACCCACTTCCCAAGAT.1	CD8+T cell
ACCCACTTCCTACAGA.1	naïve B cells
ACCCACTTCTGATTCT.1	CD8+T cell
ACCGTAACAAGTCATC.1	CD4+T cell
ACCGTAATCCAAACAC.1	NK cell
ACCTTTAAGCTTATCG.1	NK cell
ACCTTTAGTAACGACG.1	classical monocytes
ACCTTTAGTAGCAAAT.1	CD4+T cell
ACCTTTAGTTGTTTGG.1	CD8+T cell
ACGAGCCGTGCCTTGG.1	CD4+T cell
ACGAGGACAGGGATTG.1	classical monocytes
ACGAGGAGTCCCGACA.1	CD8+T cell
ACGAGGAGTGTCCTCT.1	CD4+T cell
ACGAGGATCGGAAACG.1	CD8+T cell
ACGATACTCCGTCATC.1	CD4+T cell
ACGATGTTCTGCGACG.1	CD4+T cell
ACGCAGCAGCACACAG.1	NK cell
ACGCAGCGTTGCGCAC.1	CD4+T cell
ACGCAGCTCCGAATGT.1	CD8+T cell
ACGCAGCTCGAATCCA.1	NK cell
ACGCAGCTCTCTGAGA.1	CD4+T cell
ACGCCAGTCAAAGTAG.1	classical monocytes
ACGCCAGTCAAGCCTA.1	CD4+T cell
ACGCCGAAGGAGCGAG.1	CD8+T cell
ACGCCGACACGTCAGC.1	CD8+T cell
ACGGAGACACGCCAGT.1	NK cell
ACGGAGACATCATCCC.1	NK cell
ACGGAGAGTATCACCA.1	CD8+T cell
ACGGCCACAGGGAGAG.1	CD4+T cell
ACGGCCACATCCTAGA.1	CD4+T cell
ACGGCCATCTCGCTTG.1	CD4+T cell
ACGGGCTAGGAGTACC.1	classical monocytes
ACGGGCTCAGCTGGCT.1	CD4+T cell
ACGGGCTGTACCGAGA.1	naïve B cells
ACGGGCTTCGAATGGG.1	CD4+T cell
ACGGGTCCAAACCTAC.1	classical monocytes
ACGGGTCCAAGAAGAG.1	NK cell
ACGTCAAAGTAGGCCA.1	NK cell
ACGTCAAGTGACTACT.1	CD8+T cell
ACGTCAATCCTAAGTG.1	CD4+T cell
ACTATCTAGTGAATTG.1	CD4+T cell
ACTATCTCAAGGTTTC.1	CD4+T cell
ACTATCTGTCTAGAGG.1	CD4+T cell
ACTATCTTCCAAGTAC.1	CD8+T cell
ACTATCTTCTTGTACT.1	CD4+T cell
ACTGAACAGGTGCTTT.1	NK cell
ACTGAACCAAGCCGCT.1	NK cell
ACTGAACCAGATGGGT.1	NK cell
ACTGAACTCATTTGGG.1	CD4+T cell
ACTGAGTCAGACTCGC.1	NK cell
ACTGATGCATTGGCGC.1	NK cell
ACTGCTCCAACTTGAC.1	CD4+T cell
ACTGCTCCATCCCATC.1	CD8+T cell
ACTGCTCTCTACCAGA.1	CD4+T cell
ACTGTCCAGAGTGAGA.1	classical monocytes
ACTGTCCAGGTGATTA.1	CD4+T cell
ACTGTCCTCCGCATAA.1	CD4+T cell
ACTTACTAGACTTTCG.1	classical monocytes
ACTTACTCATTCTTAC.1	naïve B cells
ACTTGTTAGCTCCTCT.1	NK cell
ACTTGTTTCCAAACTG.1	NK cell
ACTTTCAGTTCCACTC.1	NK cell
ACTTTCATCCGCGCAA.1	NK cell
AGAATAGGTACAGACG.1	CD4+T cell
AGAATAGGTACCGTTA.1	CD8+T cell
AGAATAGGTGTTAAGA.1	CD4+T cell
AGAATAGTCAGGCGAA.1	CD4+T cell
AGACGTTCATACCATG.1	CD8+T cell
AGAGCGACACCCTATC.1	CD4+T cell
AGAGCTTCAGATTGCT.1	classical monocytes
AGAGCTTCATGTCGAT.1	CD4+T cell
AGAGCTTGTGCGGTAA.1	NK cell
AGAGCTTTCCCAAGAT.1	classical monocytes
AGAGTGGAGGACGAAA.1	naïve B cells
AGAGTGGTCACCCGAG.1	CD4+T cell
AGATCTGAGCAGCGTA.1	classical monocytes
AGATCTGAGGCATGGT.1	NK cell
AGATCTGAGTACGACG.1	CD4+T cell
AGATCTGCACCGAATT.1	classical monocytes
AGATCTGTCGAGAGCA.1	classical monocytes
AGATCTGTCTGGTGTA.1	CD4+T cell
AGATTGCAGCAGACTG.1	NK cell
AGATTGCCAGCGAACA.1	CD8+T cell
AGATTGCGTGTCGCTG.1	classical monocytes
AGATTGCGTGTTAAGA.1	CD4+T cell
AGCAGCCCAGTGGAGT.1	CD4+T cell
AGCAGCCTCTGGTGTA.1	CD4+T cell
AGCATACAGAACAACT.1	CD4+T cell
AGCCTAACAAAGCGGT.1	NK cell
AGCCTAACACACATGT.1	CD4+T cell
AGCCTAAGTTATCGGT.1	CD4+T cell
AGCGGTCAGCTAACAA.1	NK cell
AGCGGTCCAAGTAATG.1	CD4+T cell
AGCGGTCCACCCTATC.1	CD4+T cell
AGCGGTCGTTACTGAC.1	CD4+T cell
AGCGTATAGATGTTAG.1	NK cell
AGCGTATCACCAGCAC.1	CD4+T cell
AGCGTATGTTGAACTC.1	NK cell
AGCTCCTAGGTCGGAT.1	NK cell
AGCTCCTCAGGGAGAG.1	CD8+T cell
AGCTCTCGTCGCATCG.1	CD4+T cell
AGCTCTCTCATCACCC.1	CD4+T cell
AGCTTGAAGAGGTTAT.1	CD4+T cell
AGGCCACAGGTGTGGT.1	CD4+T cell
AGGCCACCATGCCTTC.1	NK cell
AGGCCACGTTCCACGG.1	NK cell
AGGCCACTCGAATGCT.1	CD4+T cell
AGGCCGTAGTGACTCT.1	NK cell
AGGCCGTCAAGTTGTC.1	NK cell
AGGCCGTCATCCGCGA.1	CD8+T cell
AGGCCGTGTTGTTTGG.1	NK cell
AGGGAGTCACGGTGTC.1	CD4+T cell
AGGGAGTGTCCAGTTA.1	CD4+T cell
AGGGATGAGGCCCTCA.1	classical monocytes
AGGGATGGTTCCACTC.1	classical monocytes
AGGGATGTCGGTGTTA.1	CD4+T cell
AGGGTGAAGATCCGAG.1	CD4+T cell
AGGGTGAAGCTGAAAT.1	CD8+T cell
AGGGTGAAGTCACGCC.1	NK cell
AGGGTGAGTCTGATTG.1	classical monocytes
AGGGTGAGTGAGGGTT.1	CD8+T cell
AGGTCATGTCTCAACA.1	NK cell
AGGTCCGAGTGGTCCC.1	CD8+T cell
AGTAGTCAGTCGATAA.1	CD4+T cell
AGTAGTCCAACTGGCC.1	naïve B cells
AGTAGTCCACAGACTT.1	classical monocytes
AGTAGTCCAGCTGCTG.1	NK cell
AGTGAGGCAGGCAGTA.1	CD4+T cell
AGTGGGAGTACTCTCC.1	NK cell
AGTGGGAGTCAACTGT.1	CD8+T cell
AGTGGGAGTCCCTTGT.1	CD4+T cell
AGTGTCACACAGCCCA.1	CD4+T cell
AGTTGGTCATGCTGGC.1	NK cell
AGTTGGTTCTTTAGGG.1	CD8+T cell
ATAACGCCACAACTGT.1	CD4+T cell
ATAACGCTCACATAGC.1	NK cell
ATAAGAGCAGTAGAGC.1	CD8+T cell
ATAAGAGGTAGGCTGA.1	classical monocytes
ATAGACCAGTCTCGGC.1	CD4+T cell
ATCACGAGTGTGACCC.1	classical monocytes
ATCATCTAGGCCATAG.1	CD4+T cell
ATCATCTAGGTAGCCA.1	NK cell
ATCATGGAGAATTCCC.1	CD4+T cell
ATCATGGCACAAGTAA.1	CD8+T cell
ATCATGGCACTACAGT.1	CD4+T cell
ATCATGGGTCGGCATC.1	NK cell
ATCATGGTCTACTCAT.1	CD4+T cell
ATCATGGTCTATCGCC.1	classical monocytes
ATCCACCCAGGTCTCG.1	CD4+T cell
ATCCACCTCACAATGC.1	CD8+T cell
ATCCACCTCAGTTTGG.1	CD4+T cell
ATCCACCTCTGTTTGT.1	CD4+T cell
ATCCGAAAGCACGCCT.1	NK cell
ATCCGAAAGCTGGAAC.1	CD8+T cell
ATCCGAACATTAACCG.1	NK cell
ATCCGAATCACGGTTA.1	CD8+T cell
ATCGAGTAGATCTGCT.1	CD4+T cell
ATCGAGTCAAGCTGAG.1	classical monocytes
ATCGAGTGTGACCAAG.1	NK cell
ATCGAGTGTGTTTGTG.1	CD4+T cell
ATCGAGTTCACCACCT.1	CD4+T cell
ATCTACTGTCTCCCTA.1	naïve B cells
ATCTGCCTCCACGAAT.1	NK cell
ATGAGGGCAATCCGAT.1	CD8+T cell
ATGAGGGCACAACTGT.1	CD8+T cell
ATGAGGGGTTGCCTCT.1	CD8+T cell
ATGCGATAGGGTATCG.1	NK cell
ATGCGATAGTACTTGC.1	CD4+T cell
ATGCGATAGTGTTAGA.1	classical monocytes
ATGCGATCAGAGCCAA.1	CD4+T cell
ATGGGAGCATTGGGCC.1	CD4+T cell
ATGGGAGTCTTAGAGC.1	NK cell
ATGTGTGAGAAACGAG.1	CD4+T cell
ATGTGTGGTGGTGTAG.1	CD4+T cell
ATTACTCCACAGGCCT.1	CD4+T cell
ATTACTCGTACCCAAT.1	classical monocytes
ATTACTCTCGCGTAGC.1	CD4+T cell
ATTATCCAGCTAGCCC.1	NK cell
ATTATCCAGGACAGAA.1	NK cell
ATTATCCTCCGTCAAA.1	NK cell
ATTCTACGTACGCACC.1	NK cell
ATTGGACAGCAATCTC.1	CD8+T cell
ATTGGACCAGGTCCAC.1	CD4+T cell
ATTTCTGAGAGCTATA.1	classical monocytes
ATTTCTGCAGCGAACA.1	NK cell
ATTTCTGGTAAGTTCC.1	CD8+T cell
ATTTCTGGTACCGCTG.1	CD4+T cell
ATTTCTGTCGCCTGAG.1	CD4+T cell
CAACCAAAGTGTGGCA.1	CD4+T cell
CAACCAAAGTTGTAGA.1	CD8+T cell
CAACCTCGTACAGTTC.1	CD4+T cell
CAACCTCTCCACTCCA.1	CD4+T cell
CAACCTCTCTAACGGT.1	CD4+T cell
CAACTAGTCAATACCG.1	NK cell
CAAGAAAGTTGAGGTG.1	CD4+T cell
CAAGAAATCCACGACG.1	CD8+T cell
CAAGATCAGGCATTGG.1	CD4+T cell
CAAGGCCAGGATATAC.1	NK cell
CAAGGCCTCCAAAGTC.1	CD4+T cell
CAAGGCCTCCTTAATC.1	CD4+T cell
CAAGGCCTCCTTGCCA.1	CD4+T cell
CAAGTTGAGTTATCGC.1	CD4+T cell
CAAGTTGCACCAGCAC.1	CD8+T cell
CAAGTTGGTCATATCG.1	classical monocytes
CAAGTTGGTGTGAAAT.1	classical monocytes
CAAGTTGTCTAACTCT.1	CD8+T cell
CACAAACAGGAACTGC.1	classical monocytes
CACAAACTCACATAGC.1	CD4+T cell
CACAAACTCTCAAACG.1	NK cell
CACACAACAAGGGTCA.1	NK cell
CACACAACATCATCCC.1	CD4+T cell
CACACAAGTACGCTGC.1	CD4+T cell
CACACCTAGTAAGTAC.1	CD4+T cell
CACACCTCAATGTAAG.1	CD4+T cell
CACACTCGTAACGTTC.1	CD8+T cell
CACACTCGTAAGGGAA.1	CD4+T cell
CACACTCTCAACGGGA.1	classical monocytes
CACAGGCGTCTGCGGT.1	CD8+T cell
CACAGTAAGCATCATC.1	CD4+T cell
CACAGTACACAGATTC.1	NK cell
CACAGTATCGTGGTCG.1	CD4+T cell
CACATAGAGTGCGATG.1	CD4+T cell
CACATAGGTTTGTTTC.1	CD4+T cell
CACATTTCAGCAGTTT.1	naïve B cells
CACATTTTCCACGACG.1	CD4+T cell
CACCACTAGGACATTA.1	CD8+T cell
CACCACTAGGCTAGGT.1	CD4+T cell
CACCACTCACAGCCCA.1	NK cell
CACCACTTCCTGCTTG.1	CD4+T cell
CACCACTTCGCATGAT.1	CD4+T cell
CACCAGGTCTAACGGT.1	classical monocytes
CACCTTGAGCTGTTCA.1	CD4+T cell
CACTCCACAGCAGTTT.1	CD8+T cell
CAGAATCAGCAGATCG.1	CD8+T cell
CAGAATCCATTACCTT.1	CD8+T cell
CAGAATCTCAATCTCT.1	NK cell
CAGAATCTCACGACTA.1	CD4+T cell
CAGAGAGAGTGGAGTC.1	NK cell
CAGAGAGTCCGCAAGC.1	NK cell
CAGATCAAGCCGCCTA.1	CD4+T cell
CAGATCACAGCTATTG.1	CD8+T cell
CAGATCATCCACTCCA.1	CD8+T cell
CAGCAGCTCAGTTGAC.1	CD8+T cell
CAGCATAGTTCATGGT.1	CD4+T cell
CAGCCGAGTCAAGCGA.1	CD4+T cell
CAGCCGAGTGTTGAGG.1	classical monocytes
CAGCCGATCGTGGTCG.1	CD4+T cell
CAGCGACAGATCCGAG.1	CD8+T cell
CAGCGACTCACCTCGT.1	CD8+T cell
CAGCTAAAGAGTAATC.1	CD4+T cell
CAGCTAAGTAGGAGTC.1	NK cell
CAGCTAAGTGCAGGTA.1	CD4+T cell
CAGCTAAGTTTAGCTG.1	NK cell
CAGCTGGCAGCTGTGC.1	CD8+T cell
CAGCTGGCAGTTCCCT.1	CD4+T cell
CAGCTGGGTCTCTTTA.1	CD4+T cell
CAGGTGCAGGAATTAC.1	CD4+T cell
CAGGTGCCACAGCGTC.1	CD4+T cell
CAGGTGCCAGCAGTTT.1	classical monocytes
CAGTAACCACGAAGCA.1	CD8+T cell
CAGTAACGTCCAGTTA.1	CD4+T cell
CAGTAACGTCGAGATG.1	classical monocytes
CAGTCCTTCGCCAAAT.1	CD4+T cell
CAGTCCTTCTGGTATG.1	CD4+T cell
CATATGGTCAACACCA.1	CD4+T cell
CATATGGTCCCTAATT.1	naïve B cells
CATATTCAGAAACCGC.1	classical monocytes
CATATTCAGATGGCGT.1	CD8+T cell
CATATTCAGCGCTTAT.1	CD4+T cell
CATATTCTCGGTCTAA.1	CD4+T cell
CATCAAGAGTGAAGTT.1	NK cell
CATCAAGGTATAGTAG.1	classical monocytes
CATCAAGTCGCTGATA.1	NK cell
CATCAGAGTGGCCCTA.1	classical monocytes
CATCAGAGTTTGGGCC.1	CD4+T cell
CATCAGATCATCTGCC.1	NK cell
CATCCACCAGGAATGC.1	CD8+T cell
CATCGGGAGTTCGATC.1	CD4+T cell
CATCGGGCAGCCACCA.1	NK cell
CATCGGGGTGCGGTAA.1	CD8+T cell
CATCGGGTCGAGGTAG.1	NK cell
CATGACAAGATCCTGT.1	CD4+T cell
CATGACAAGTACTTGC.1	CD4+T cell
CATGACAGTCCAACTA.1	NK cell
CATGACAGTTCGGCAC.1	CD8+T cell
CATGACATCACCATAG.1	NK cell
CATGCCTAGAGGTAGA.1	NK cell
CATGGCGCAGGACCCT.1	CD4+T cell
CATTATCCAGACTCGC.1	CD8+T cell
CATTATCCATGCCTTC.1	CD8+T cell
CATTATCTCCGCGTTT.1	CD8+T cell
CATTATCTCTGACCTC.1	NK cell
CATTCGCAGCGATATA.1	NK cell
CATTCGCCAAGACGTG.1	CD4+T cell
CATTCGCCATGTTCCC.1	CD4+T cell
CATTCGCGTCTGGTCG.1	CD8+T cell
CATTCGCTCAGTTAGC.1	CD8+T cell
CATTCGCTCGGTTCGG.1	CD4+T cell
CCAATCCAGACTAGAT.1	CD8+T cell
CCAATCCAGGTGACCA.1	CD4+T cell
CCAATCCTCGCATGGC.1	NK cell
CCACCTAAGCTGTCTA.1	CD4+T cell
CCACCTACACCCTATC.1	CD4+T cell
CCACGGACACGCATCG.1	CD8+T cell
CCACTACAGGTAGCCA.1	CD4+T cell
CCACTACTCTCCAACC.1	CD4+T cell
CCAGCGACAGTAGAGC.1	CD4+T cell
CCAGCGACATACTACG.1	CD4+T cell
CCATGTCAGCCGTCGT.1	CD4+T cell
CCATGTCAGTGTGGCA.1	CD4+T cell
CCATGTCCAATTCCTT.1	CD4+T cell
CCATGTCCATAAAGGT.1	classical monocytes
CCATGTCGTCAACTGT.1	naïve B cells
CCATGTCGTCATCGGC.1	classical monocytes
CCATGTCGTTGGTTTG.1	NK cell
CCATGTCTCAGTTAGC.1	CD8+T cell
CCATTCGAGTAGTGCG.1	CD4+T cell
CCCAATCAGTTAGCGG.1	CD4+T cell
CCCAATCGTGACTACT.1	CD4+T cell
CCCAATCTCTAACCGA.1	CD4+T cell
CCCAGTTAGTGGAGTC.1	CD4+T cell
CCCAGTTGTTAAAGTG.1	NK cell
CCCATACAGGTCGGAT.1	CD4+T cell
CCCTCCTCACGAGAGT.1	naïve B cells
CCCTCCTCATCTACGA.1	classical monocytes
CCGGGATCATTTCAGG.1	NK cell
CCGGGATTCTGGCGAC.1	naïve B cells
CCGGTAGTCGTGGGAA.1	CD4+T cell
CCGTACTAGTGAATTG.1	NK cell
CCGTACTCATTCTTAC.1	classical monocytes
CCGTACTGTCCGTGAC.1	CD8+T cell
CCGTACTTCCGGCACA.1	classical monocytes
CCGTGGAAGTGGCACA.1	CD4+T cell
CCGTGGACAGACGCTC.1	CD8+T cell
CCGTTCAAGGCATTGG.1	classical monocytes
CCGTTCATCTCTTATG.1	CD4+T cell
CCTAAAGAGGCACATG.1	CD4+T cell
CCTAAAGTCAGTTCGA.1	NK cell
CCTACACGTGCTCTTC.1	CD4+T cell
CCTACCATCTTGAGAC.1	NK cell
CCTATTAAGATCACGG.1	CD4+T cell
CCTATTATCAGGCAAG.1	classical monocytes
CCTCAGTGTCAGTGGA.1	NK cell
CCTCTGAAGTACGCCC.1	CD4+T cell
CCTTACGAGGATGCGT.1	NK cell
CCTTACGAGGTTCCTA.1	CD4+T cell
CCTTACGCACATAACC.1	CD4+T cell
CCTTACGCAGGGCATA.1	NK cell
CCTTACGTCAGTACGT.1	CD4+T cell
CCTTCCCCATTGCGGC.1	NK cell
CCTTCCCGTAAGGGCT.1	NK cell
CCTTCCCTCGCAAACT.1	CD4+T cell
CCTTCGAGTAGGGTAC.1	CD4+T cell
CCTTCGATCTTGTATC.1	classical monocytes
CGAACATGTGAGTATA.1	CD8+T cell
CGAACATGTTGCGCAC.1	NK cell
CGAACATTCCTCAACC.1	classical monocytes
CGAATGTCAAATCCGT.1	CD4+T cell
CGAATGTGTCGATTGT.1	CD8+T cell
CGAATGTTCGATCCCT.1	CD4+T cell
CGACCTTAGTCAAGGC.1	CD8+T cell
CGACTTCAGGGCTTGA.1	CD4+T cell
CGACTTCCACTCAGGC.1	classical monocytes
CGAGAAGCAACGATGG.1	CD4+T cell
CGAGAAGTCCCAACGG.1	CD8+T cell
CGAGCACCAGCAGTTT.1	CD4+T cell
CGAGCACTCACGCGGT.1	CD4+T cell
CGAGCCAAGTTGAGTA.1	CD4+T cell
CGAGCCACAGACAGGT.1	NK cell
CGAGCCAGTCCAACTA.1	CD4+T cell
CGAGCCAGTTAAAGTG.1	CD4+T cell
CGAGCCATCAGCAACT.1	classical monocytes
CGATCGGCACGAGAGT.1	CD8+T cell
CGATGGCAGTGTGGCA.1	classical monocytes
CGATGGCCAGTATGCT.1	CD4+T cell
CGATGGCTCGTCACGG.1	NK cell
CGATGTAAGAATTGTG.1	classical monocytes
CGATGTACAAGGACAC.1	CD4+T cell
CGATGTACATCGACGC.1	classical monocytes
CGATGTAGTAGAAAGG.1	CD4+T cell
CGATTGAGTCGCATAT.1	CD4+T cell
CGCCAAGTCGCGTAGC.1	CD4+T cell
CGCGGTAAGCGTAATA.1	CD8+T cell
CGCGGTACAGGTGGAT.1	CD4+T cell
CGCGGTACATCGGACC.1	classical monocytes
CGCGGTAGTCCCTTGT.1	NK cell
CGCGGTAGTTAGGGTG.1	CD4+T cell
CGCGTTTAGCACACAG.1	CD4+T cell
CGCGTTTGTCGAATCT.1	CD8+T cell
CGCGTTTGTTAAGAAC.1	CD8+T cell
CGCGTTTTCAAAGTAG.1	NK cell
CGCGTTTTCCGTTGCT.1	NK cell
CGCTATCCATGACATC.1	CD4+T cell
CGCTATCGTCCATGAT.1	CD4+T cell
CGCTTCAGTAGGACAC.1	NK cell
CGCTTCAGTCTGCGGT.1	CD4+T cell
CGCTTCAGTGGACGAT.1	classical monocytes
CGGACACCACGCATCG.1	CD4+T cell
CGGACACCACTTGGAT.1	CD8+T cell
CGGACACGTTGGACCC.1	CD8+T cell
CGGACACTCCCAGGTG.1	CD4+T cell
CGGACACTCCTTGACC.1	CD4+T cell
CGGACGTAGCGTTTAC.1	CD8+T cell
CGGACGTTCCAATGGT.1	CD4+T cell
CGGACTGTCATATCGG.1	CD4+T cell
CGGAGCTAGACAATAC.1	CD4+T cell
CGGAGCTAGTCATGCT.1	CD4+T cell
CGGAGCTGTGAACCTT.1	CD4+T cell
CGGAGCTTCCACGCAG.1	CD8+T cell
CGGAGCTTCTCGGACG.1	CD4+T cell
CGGAGTCCATGCTAGT.1	CD4+T cell
CGGAGTCGTCAACTGT.1	CD4+T cell
CGGCTAGAGAAGGCCT.1	CD8+T cell
CGGCTAGCAACTGCGC.1	CD8+T cell
CGGCTAGCAACTGCTA.1	CD8+T cell
CGGCTAGCACCCAGTG.1	CD8+T cell
CGGGTCAAGGAATGGA.1	CD4+T cell
CGGGTCAGTACTCGCG.1	CD8+T cell
CGGGTCATCCGATATG.1	CD4+T cell
CGGTTAATCACCGGGT.1	CD4+T cell
CGTAGCGAGGGTGTGT.1	CD4+T cell
CGTAGCGAGTACACCT.1	classical monocytes
CGTAGCGAGTCTTGCA.1	classical monocytes
CGTAGGCAGCTGATAA.1	classical monocytes
CGTAGGCAGGACAGCT.1	classical monocytes
CGTCACTTCGGCCGAT.1	classical monocytes
CGTCACTTCTGGTTCC.1	CD4+T cell
CGTCAGGTCGTCTGCT.1	NK cell
CGTCCATAGATCCGAG.1	CD4+T cell
CGTCCATAGTCATCCA.1	naïve B cells
CGTCCATCACGTAAGG.1	CD8+T cell
CGTCCATCATGCCCGA.1	NK cell
CGTCCATGTCCTCCAT.1	CD4+T cell
CGTCCATTCGATCCCT.1	CD8+T cell
CGTCTACAGCAGCCTC.1	CD4+T cell
CGTCTACGTCCTCCAT.1	CD4+T cell
CGTGAGCCACCTCGTT.1	CD4+T cell
CGTGAGCCAGGGCATA.1	naïve B cells
CGTGAGCGTTGTCTTT.1	classical monocytes
CGTGTCTTCTACGAGT.1	CD8+T cell
CGTTAGAAGTCAAGGC.1	CD4+T cell
CGTTAGACACGGTAAG.1	CD4+T cell
CGTTAGACATCACCCT.1	CD4+T cell
CGTTCTGGTATCGCAT.1	CD4+T cell
CGTTGGGGTTTAAGCC.1	CD4+T cell
CTAACTTGTCTCTTAT.1	NK cell
CTAAGACAGCCAGTAG.1	CD8+T cell
CTAAGACCATACCATG.1	CD8+T cell
CTAAGACTCGCGTAGC.1	CD4+T cell
CTAATGGAGAACTCGG.1	CD8+T cell
CTAATGGAGAGACTTA.1	NK cell
CTAATGGCAAGAGTCG.1	CD4+T cell
CTACACCAGCGGCTTC.1	NK cell
CTACATTAGCAGGTCA.1	classical monocytes
CTACATTAGCCAACAG.1	NK cell
CTACATTTCACCATAG.1	CD8+T cell
CTACCCAAGCTAACAA.1	CD8+T cell
CTACCCACAAACAACA.1	NK cell
CTACCCACATGTAGTC.1	CD4+T cell
CTACCCATCGCCGTGA.1	CD4+T cell
CTACGTCAGTGTGAAT.1	classical monocytes
CTACGTCCAATCTACG.1	CD4+T cell
CTACGTCGTTGACGTT.1	CD8+T cell
CTACGTCTCGTCCGTT.1	CD4+T cell
CTAGAGTCACCGAAAG.1	CD4+T cell
CTAGCCTGTCTGGAGA.1	NK cell
CTAGTGACAGCTGCAC.1	CD4+T cell
CTAGTGACATTGAGCT.1	CD4+T cell
CTCACACTCAGGCAAG.1	CD4+T cell
CTCACACTCCATGAGT.1	CD4+T cell
CTCATTAAGATGCCAG.1	NK cell
CTCATTACACAGCCCA.1	CD8+T cell
CTCATTACATGCGCAC.1	CD4+T cell
CTCATTAGTGAAATCA.1	NK cell
CTCATTATCGCAGGCT.1	CD4+T cell
CTCCTAGAGGACAGCT.1	CD8+T cell
CTCGAAAAGATATACG.1	CD4+T cell
CTCGAAAAGCTACCGC.1	CD4+T cell
CTCGAAACAGGAACGT.1	NK cell
CTCGAAAGTACAGACG.1	CD4+T cell
CTCGAGGAGTGTACGG.1	CD8+T cell
CTCGAGGCAGTTCATG.1	NK cell
CTCGAGGGTCTCTTAT.1	CD4+T cell
CTCGGAGAGACATAAC.1	CD4+T cell
CTCGGAGTCGTATCAG.1	CD4+T cell
CTCGGGAAGGGTTTCT.1	CD4+T cell
CTCGTACGTCTGCCAG.1	CD4+T cell
CTCGTACTCATTGCGA.1	NK cell
CTCGTACTCCACGAAT.1	CD4+T cell
CTCGTCAAGGCATGGT.1	CD8+T cell
CTCGTCACATATACCG.1	CD8+T cell
CTCGTCACATGAACCT.1	CD4+T cell
CTCTAATAGGATTCGG.1	classical monocytes
CTCTAATTCGGTGTTA.1	CD4+T cell
CTCTGGTAGCTAACTC.1	CD4+T cell
CTCTGGTGTCATGCCG.1	NK cell
CTCTGGTTCTTAGAGC.1	classical monocytes
CTGAAACAGCCTTGAT.1	NK cell
CTGAAGTCATCTGGTA.1	CD4+T cell
CTGAAGTGTCACACGC.1	NK cell
CTGAAGTGTCGTGGCT.1	NK cell
CTGAAGTTCTTGCATT.1	CD8+T cell
CTGATAGGTATAGGGC.1	CD4+T cell
CTGATCCCAGGATTGG.1	CD4+T cell
CTGCCTAAGACATAAC.1	CD4+T cell
CTGCCTAAGATAGCAT.1	NK cell
CTGCCTACACGTAAGG.1	CD8+T cell
CTGCCTAGTGCCTGGT.1	CD8+T cell
CTGCGGACAATAAGCA.1	NK cell
CTGCGGACATATGAGA.1	classical monocytes
CTGCGGATCATTGCCC.1	CD8+T cell
CTGCGGATCCGCTGTT.1	CD4+T cell
CTGCTGTAGCTGTCTA.1	NK cell
CTGCTGTTCATTGCGA.1	CD4+T cell
CTGGTCTAGAATAGGG.1	NK cell
CTGTGCTAGCGATGAC.1	CD8+T cell
CTGTGCTAGGTGCTAG.1	CD4+T cell
CTGTGCTGTGCAACTT.1	CD4+T cell
CTGTTTACACTTCGAA.1	CD8+T cell
CTGTTTATCCAAAGTC.1	CD4+T cell
CTTAACTAGGCATGGT.1	CD4+T cell
CTTAACTCATCGACGC.1	CD8+T cell
CTTAACTGTTGCGCAC.1	NK cell
CTTACCGAGACTAAGT.1	CD4+T cell
CTTACCGGTACCGTAT.1	CD4+T cell
CTTACCGGTTGCTCCT.1	CD4+T cell
CTTACCGGTTTAGCTG.1	CD8+T cell
CTTACCGTCATCACCC.1	NK cell
CTTACCGTCTCGATGA.1	CD4+T cell
CTTAGGACATCGGAAG.1	NK cell
CTTAGGATCTCAAACG.1	NK cell
CTTCTCTTCCGCATAA.1	CD4+T cell
CTTGGCTGTAAGCACG.1	NK cell
CTTGGCTTCGAATGCT.1	CD4+T cell
CTTTGCGAGCGGATCA.1	CD4+T cell
CTTTGCGGTTCTGGTA.1	CD4+T cell
CTTTGCGTCACCACCT.1	CD4+T cell
GAAACTCGTCGTTGTA.1	CD4+T cell
GAAACTCTCTGCTTGC.1	NK cell
GAAATGATCAACACCA.1	CD8+T cell
GAAATGATCGGAAATA.1	CD4+T cell
GAAATGATCGGTCCGA.1	CD4+T cell
GAACATCAGCCACCTG.1	CD8+T cell
GAACCTACAGATGGCA.1	classical monocytes
GAACCTACATGCTAGT.1	NK cell
GAACCTATCAACACCA.1	CD8+T cell
GAACGGAGTCACCCAG.1	CD4+T cell
GAACGGATCCGATATG.1	CD4+T cell
GAAGCAGGTGATGTCT.1	CD8+T cell
GAATAAGAGGTGCTAG.1	NK cell
GAATAAGAGTGTGGCA.1	CD8+T cell
GAATAAGCACTAGTAC.1	NK cell
GAATAAGCATCACGTA.1	CD4+T cell
GAATAAGTCATCTGTT.1	NK cell
GAATGAACAAGCGAGT.1	CD8+T cell
GAATGAATCGTGGGAA.1	CD4+T cell
GACACGCGTTAGGGTG.1	classical monocytes
GACCAATAGAGCCCAA.1	NK cell
GACCAATGTTCGTGAT.1	NK cell
GACCTGGAGCAGCCTC.1	CD4+T cell
GACCTGGTCGAATCCA.1	CD4+T cell
GACCTGGTCGTTTGCC.1	CD4+T cell
GACGCGTGTACCATCA.1	CD4+T cell
GACGCGTGTCGCTTCT.1	CD4+T cell
GACGGCTCACACTGCG.1	CD8+T cell
GACGGCTCAGGTGGAT.1	classical monocytes
GACGGCTTCGCGGATC.1	CD8+T cell
GACGTGCAGCTTCGCG.1	CD4+T cell
GACGTGCCAATGGAGC.1	classical monocytes
GACGTGCTCCTAAGTG.1	NK cell
GACTAACTCTGCTGTC.1	NK cell
GACTACAAGAGAGCTC.1	CD8+T cell
GACTACAAGATGGCGT.1	CD8+T cell
GACTACAAGGCCCTTG.1	CD8+T cell
GAGCAGAAGTAATCCC.1	CD4+T cell
GAGCAGACACGAGAGT.1	CD4+T cell
GAGCAGATCCGTAGGC.1	NK cell
GAGGTGAAGATGTCGG.1	CD4+T cell
GAGTCCGAGCTCCCAG.1	NK cell
GAGTCCGCAGCGAACA.1	CD4+T cell
GAGTCCGCAGTACACT.1	CD4+T cell
GAGTCCGTCAAACAAG.1	CD4+T cell
GAGTCCGTCACAAACC.1	CD8+T cell
GAGTCCGTCTTGGGTA.1	CD8+T cell
GATCAGTAGGATGTAT.1	CD4+T cell
GATCGATCAGCTGCTG.1	naïve B cells
GATCGATTCTCAACTT.1	NK cell
GATCGCGCATCACAAC.1	NK cell
GATCGTAAGAGACTAT.1	CD4+T cell
GATCGTAAGGCTCAGA.1	CD8+T cell
GATCGTACATGTCTCC.1	classical monocytes
GATCGTATCCATTCTA.1	NK cell
GATGAAAAGGACTGGT.1	classical monocytes
GATGAAACAAGAGTCG.1	NK cell
GATGAAAGTCTCCACT.1	CD4+T cell
GATGAAAGTTGTACAC.1	CD4+T cell
GATGAGGAGGCTAGAC.1	CD4+T cell
GATGAGGAGTTCGCAT.1	CD4+T cell
GATGAGGTCAGAGCTT.1	naïve B cells
GATGAGGTCGACGGAA.1	CD4+T cell
GATGAGGTCTTCGGTC.1	CD4+T cell
GATGCTACACTTAAGC.1	classical monocytes
GATTCAGCACTTGGAT.1	CD8+T cell
GATTCAGCAGGTGGAT.1	classical monocytes
GATTCAGGTGAGTATA.1	CD8+T cell
GATTCAGGTGATGATA.1	CD4+T cell
GCAAACTCAGCTGTTA.1	NK cell
GCAATCACACCACGTG.1	CD4+T cell
GCAATCACACGTCTCT.1	CD4+T cell
GCACATAAGCAAATCA.1	NK cell
GCACATACACAGCGTC.1	CD8+T cell
GCACATACACGACTCG.1	CD8+T cell
GCACTCTGTCTTCGTC.1	naïve B cells
GCACTCTGTGTCGCTG.1	CD8+T cell
GCACTCTTCAAACCGT.1	CD4+T cell
GCAGCCACATCAGTAC.1	CD4+T cell
GCAGCCATCGGTGTTA.1	CD8+T cell
GCAGCCATCTCACATT.1	NK cell
GCAGTTAAGACTAGAT.1	classical monocytes
GCAGTTACACCACCAG.1	NK cell
GCAGTTACACCAGGTC.1	CD4+T cell
GCATACACAAGTCTGT.1	CD4+T cell
GCATACATCCTTGCCA.1	CD4+T cell
GCATGATCATCGATTG.1	CD4+T cell
GCATGCGAGACACGAC.1	naïve B cells
GCATGCGAGGCCCTCA.1	classical monocytes
GCATGTATCCTAAGTG.1	CD4+T cell
GCCAAATAGACTAAGT.1	CD8+T cell
GCCTCTAAGTAGCGGT.1	CD8+T cell
GCGACCAGTAAACACA.1	CD4+T cell
GCGACCATCTAAGCCA.1	NK cell
GCGAGAAAGGCTAGGT.1	CD4+T cell
GCGAGAAAGTTGAGAT.1	classical monocytes
GCGAGAAGTGGCCCTA.1	classical monocytes
GCGAGAATCATCTGCC.1	classical monocytes
GCGCAACCACCTGGTG.1	NK cell
GCGCAACGTAGCTTGT.1	CD8+T cell
GCGCAACGTTCAACCA.1	CD4+T cell
GCGCAACTCACTTACT.1	CD4+T cell
GCGCAGTAGGACACCA.1	NK cell
GCGCAGTGTCTCCATC.1	CD8+T cell
GCGCCAAAGCACGCCT.1	CD8+T cell
GCGCCAACAATCTACG.1	CD8+T cell
GCGCCAACACAGCGTC.1	classical monocytes
GCGCGATAGCGTAATA.1	CD4+T cell
GCGCGATAGTACGCGA.1	classical monocytes
GCGCGATCATTGGGCC.1	CD4+T cell
GCGCGATGTCATATGC.1	CD8+T cell
GCGGGTTAGCCACGCT.1	NK cell
GCGGGTTAGCGATATA.1	CD8+T cell
GCGGGTTTCTTGTATC.1	CD4+T cell
GCTCCTAAGGTGTGGT.1	classical monocytes
GCTCCTACAGATGAGC.1	CD8+T cell
GCTCCTATCAACTCTT.1	CD4+T cell
GCTCTGTGTAGGGACT.1	CD8+T cell
GCTGCAGAGAGGACGG.1	NK cell
GCTGCAGAGCTAACAA.1	NK cell
GCTGCAGGTCTGATCA.1	NK cell
GCTGCAGTCGGATGGA.1	CD4+T cell
GCTGCGAAGTGGAGTC.1	CD4+T cell
GCTGCTTAGGCAATTA.1	CD4+T cell
GCTGCTTTCGATAGAA.1	CD8+T cell
GCTTCCAGTAAAGTCA.1	CD8+T cell
GCTTCCAGTAGCTTGT.1	CD8+T cell
GCTTGAATCTGATTCT.1	CD4+T cell
GGAAAGCCAGACAAGC.1	NK cell
GGAAAGCTCTGGCGAC.1	CD4+T cell
GGAACTTGTCGATTGT.1	CD4+T cell
GGAACTTGTTCCACAA.1	CD8+T cell
GGAATAACATCACGTA.1	NK cell
GGAATAATCCAAACAC.1	CD8+T cell
GGACAAGCACATAACC.1	classical monocytes
GGACAAGCACCAGCAC.1	classical monocytes
GGACAAGGTAAGAGGA.1	CD4+T cell
GGACAGAGTCTGATTG.1	NK cell
GGACATTCAATGGAGC.1	classical monocytes
GGACATTTCCATTCTA.1	NK cell
GGACGTCCAGCGAACA.1	NK cell
GGAGCAATCACCACCT.1	NK cell
GGAGCAATCTCGTTTA.1	CD4+T cell
GGATGTTAGAACAACT.1	CD4+T cell
GGATGTTAGCGAAGGG.1	CD4+T cell
GGATGTTGTAGATTAG.1	CD8+T cell
GGATTACAGTGCAAGC.1	CD4+T cell
GGCAATTTCAACGCTA.1	CD8+T cell
GGCAATTTCCATTCTA.1	NK cell
GGCCGATTCACCGGGT.1	CD4+T cell
GGCCGATTCCAAGCCG.1	CD8+T cell
GGCCGATTCCTGCCAT.1	CD4+T cell
GGCGACTAGGACATTA.1	CD4+T cell
GGCGACTCACGAAAGC.1	CD8+T cell
GGCGACTCACTTCTGC.1	CD4+T cell
GGCGACTCAGACGCCT.1	CD8+T cell
GGCGACTGTTATTCTC.1	CD4+T cell
GGCGTGTTCCGCTGTT.1	CD4+T cell
GGCGTGTTCTTGAGAC.1	NK cell
GGCTGGTAGTGCAAGC.1	CD4+T cell
GGCTGGTGTCACTTCC.1	CD4+T cell
GGCTGGTGTCCTAGCG.1	NK cell
GGGAATGAGATCGGGT.1	CD8+T cell
GGGAATGGTGAAGGCT.1	CD8+T cell
GGGAATGTCAACCAAC.1	CD8+T cell
GGGACCTAGATGTAAC.1	CD4+T cell
GGGACCTTCACAAACC.1	CD4+T cell
GGGACCTTCCTTTCGG.1	CD8+T cell
GGGAGATCAATCGGTT.1	classical monocytes
GGGAGATCACAACGTT.1	classical monocytes
GGGAGATCATCGGGTC.1	naïve B cells
GGGAGATGTTCCGTCT.1	CD4+T cell
GGGAGATTCTGAGGGA.1	NK cell
GGGATGACAATGAATG.1	CD4+T cell
GGGATGACATGGTAGG.1	CD8+T cell
GGGATGAGTAGGGTAC.1	NK cell
GGGATGAGTGAGCGAT.1	NK cell
GGGATGATCCTAGTGA.1	CD8+T cell
GGGATGATCTGGAGCC.1	CD4+T cell
GGGCACTCACGGATAG.1	CD4+T cell
GGGTCTGCAGCCTTGG.1	CD4+T cell
GGGTCTGCAGTCGTGC.1	CD4+T cell
GGGTCTGCATCACCCT.1	CD4+T cell
GGGTTGCAGTACGATA.1	CD4+T cell
GGGTTGCTCAGAGCTT.1	CD4+T cell
GGGTTGCTCCGAATGT.1	CD4+T cell
GGTATTGAGACAGGCT.1	CD4+T cell
GGTATTGAGGTAGCTG.1	CD4+T cell
GGTATTGGTCCTCTTG.1	classical monocytes
GGTGAAGAGATCGGGT.1	classical monocytes
GGTGAAGCATTACGAC.1	NK cell
GGTGAAGTCCAGGGCT.1	CD4+T cell
GGTGCGTAGACTAGGC.1	CD4+T cell
GGTGCGTCAAACGCGA.1	CD4+T cell
GGTGCGTGTACAGTGG.1	NK cell
GGTGCGTGTGATGTCT.1	CD4+T cell
GGTGCGTTCATGTCTT.1	NK cell
GGTGTTAAGTGTTTGC.1	CD8+T cell
GGTGTTACACTTACGA.1	CD8+T cell
GGTGTTAGTTATCGGT.1	CD4+T cell
GGTGTTATCCCTTGTG.1	NK cell
GTAACGTAGTGCCAGA.1	NK cell
GTAACGTCAACTTGAC.1	NK cell
GTAACGTGTTACAGAA.1	CD8+T cell
GTAACGTGTTGACGTT.1	CD4+T cell
GTAACTGCATTGGCGC.1	CD4+T cell
GTAACTGTCTCAAGTG.1	classical monocytes
GTACGTACACGTTGGC.1	CD4+T cell
GTACGTAGTCTGGTCG.1	naïve B cells
GTACGTATCACTTATC.1	CD4+T cell
GTACTCCGTTCATGGT.1	NK cell
GTACTCCTCAAACCGT.1	CD4+T cell
GTACTCCTCGCCGTGA.1	NK cell
GTACTTTAGCTACCTA.1	NK cell
GTACTTTGTAGGGTAC.1	naïve B cells
GTAGGCCCACCCATTC.1	CD8+T cell
GTAGGCCGTCTAGTGT.1	CD4+T cell
GTAGGCCTCCGCGGTA.1	CD8+T cell
GTAGTCACAGAGCCAA.1	CD8+T cell
GTAGTCACAGCCTTTC.1	NK cell
GTAGTCATCGCCTGTT.1	CD4+T cell
GTATCTTCAACGCACC.1	CD4+T cell
GTATTCTAGCCTTGAT.1	NK cell
GTATTCTTCCGTAGTA.1	CD4+T cell
GTATTCTTCGACCAGC.1	CD4+T cell
GTATTCTTCTGCGTAA.1	NK cell
GTCAAGTAGTAGGCCA.1	CD4+T cell
GTCAAGTGTAAACGCG.1	CD8+T cell
GTCAAGTTCTTACCTA.1	naïve B cells
GTCACAACACATTCGA.1	NK cell
GTCACAATCACTATTC.1	CD4+T cell
GTCATTTGTATGAATG.1	CD4+T cell
GTCCTCAAGCAATATG.1	CD4+T cell
GTCCTCAAGCTAAACA.1	CD4+T cell
GTCCTCACAAAGTGCG.1	CD8+T cell
GTCCTCATCAGGCGAA.1	CD4+T cell
GTCGGGTAGTACGTTC.1	CD8+T cell
GTCGGGTCAAGTTAAG.1	NK cell
GTCGGGTGTGGCAAAC.1	CD4+T cell
GTCGGGTTCGTCGTTC.1	CD4+T cell
GTCGTAAAGTACGTTC.1	CD8+T cell
GTCGTAAGTCCAAGTT.1	CD4+T cell
GTCGTAAGTTGGTAAA.1	CD4+T cell
GTCTCGTAGAAGGTTT.1	CD4+T cell
GTCTCGTAGGCAGTCA.1	NK cell
GTCTTCGCAGGAATGC.1	CD8+T cell
GTCTTCGGTAGAGCTG.1	NK cell
GTCTTCGGTAGGAGTC.1	CD4+T cell
GTGAAGGAGAGCTATA.1	NK cell
GTGAAGGAGTGGAGTC.1	CD8+T cell
GTGAAGGGTTACAGAA.1	CD8+T cell
GTGCAGCTCGTAGATC.1	CD4+T cell
GTGCATAAGAATTCCC.1	CD8+T cell
GTGCATATCAAAGTAG.1	CD4+T cell
GTGCTTCGTGGCGAAT.1	classical monocytes
GTGCTTCTCATAACCG.1	CD4+T cell
GTGGGTCGTAAATGTG.1	CD4+T cell
GTGGGTCTCAGATAAG.1	CD8+T cell
GTGTGCGCAGTTCATG.1	naïve B cells
GTGTGCGCATGGGACA.1	CD4+T cell
GTGTGCGCATGGTAGG.1	NK cell
GTGTGCGGTAGGAGTC.1	CD4+T cell
GTGTGCGGTGACGGTA.1	NK cell
GTGTGCGTCGGCCGAT.1	NK cell
GTGTGCGTCTTCATGT.1	NK cell
GTGTTAGAGAGTGAGA.1	NK cell
GTGTTAGAGATAGTCA.1	CD4+T cell
GTGTTAGAGGATGTAT.1	classical monocytes
GTGTTAGTCTACCTGC.1	CD4+T cell
GTTAAGCTCGTAGGTT.1	NK cell
GTTCATTAGTGTACGG.1	CD4+T cell
GTTCATTGTAGAAGGA.1	CD8+T cell
GTTCGGGCAACGATCT.1	CD4+T cell
GTTCGGGTCATTCACT.1	CD4+T cell
GTTCTCGGTGTGACCC.1	CD4+T cell
GTTCTCGTCCTTCAAT.1	CD4+T cell
GTTCTCGTCGTTACGA.1	CD8+T cell
GTTTCTAAGCCAACAG.1	CD4+T cell
GTTTCTAGTCTCTCTG.1	NK cell
GTTTCTATCACGCATA.1	NK cell
GTTTCTATCGAATCCA.1	NK cell
TAAACCGCACGGATAG.1	NK cell
TAAACCGGTATAGGGC.1	CD4+T cell
TAAGAGAAGAATTGTG.1	CD8+T cell
TAAGAGACAGGGATTG.1	CD8+T cell
TAAGCGTCAACTGCGC.1	classical monocytes
TAAGCGTTCGGCGCAT.1	CD4+T cell
TACACGAAGCACGCCT.1	NK cell
TACACGAGTCGGCATC.1	CD4+T cell
TACAGTGAGCGGATCA.1	NK cell
TACAGTGCACGACTCG.1	CD8+T cell
TACAGTGGTAGGCTGA.1	CD4+T cell
TACAGTGGTATCGCAT.1	NK cell
TACAGTGTCAACGCTA.1	classical monocytes
TACCTATAGCTAAGAT.1	NK cell
TACCTATCATAGAAAC.1	CD8+T cell
TACCTATCATATACGC.1	CD8+T cell
TACCTATTCCATGAGT.1	CD4+T cell
TACCTATTCTTGCATT.1	CD8+T cell
TACCTTACAGACAAGC.1	CD4+T cell
TACCTTATCTCTGAGA.1	CD8+T cell
TACGGATCAGACGCTC.1	NK cell
TACGGGCTCAATCACG.1	CD4+T cell
TACGGTAAGAGGGATA.1	NK cell
TACGGTACACAACGCC.1	CD4+T cell
TACGGTAGTATCGCAT.1	NK cell
TACGGTAGTTACTGAC.1	NK cell
TACTCATAGGCCATAG.1	CD4+T cell
TACTCATAGTCGCCGT.1	CD4+T cell
TACTCGCGTAGCACGA.1	CD4+T cell
TACTTACTCCCAACGG.1	classical monocytes
TACTTGTAGACCGGAT.1	CD4+T cell
TACTTGTCAATCTGCA.1	NK cell
TACTTGTGTAGCAAAT.1	CD4+T cell
TACTTGTGTCCCGACA.1	NK cell
TACTTGTTCTTACCTA.1	CD4+T cell
TAGACCAAGATCCCGC.1	NK cell
TAGACCACATTTGCCC.1	NK cell
TAGACCAGTCCGACGT.1	CD4+T cell
TAGACCAGTTGGTTTG.1	NK cell
TAGACCATCATAACCG.1	CD4+T cell
TAGACCATCTCTTATG.1	classical monocytes
TAGACCATCTGCTGCT.1	CD4+T cell
TAGAGCTAGCCGATTT.1	naïve B cells
TAGAGCTGTATGAAAC.1	NK cell
TAGGCATAGTCATGCT.1	CD4+T cell
TAGGCATGTGCAACTT.1	CD4+T cell
TAGGCATGTGCATCTA.1	CD8+T cell
TAGGCATTCCGGGTGT.1	CD4+T cell
TAGTGGTAGAAGGGTA.1	CD4+T cell
TAGTGGTAGCATGGCA.1	CD8+T cell
TAGTGGTTCACCACCT.1	classical monocytes
TAGTTGGAGACGACGT.1	classical monocytes
TATCAGGAGTCACGCC.1	CD4+T cell
TATCTCATCTACTCAT.1	CD4+T cell
TATGCCCAGCAGCGTA.1	CD8+T cell
TATGCCCAGGCCCGTT.1	NK cell
TATGCCCGTACAGTTC.1	CD8+T cell
TATGCCCGTCGCGGTT.1	CD4+T cell
TATGCCCTCTAGCACA.1	CD8+T cell
TATTACCAGGGAAACA.1	CD8+T cell
TATTACCGTCCCGACA.1	CD8+T cell
TATTACCTCCTATTCA.1	CD4+T cell
TCAATCTCAGACTCGC.1	CD4+T cell
TCAATCTTCACCCTCA.1	CD8+T cell
TCAATCTTCTCGATGA.1	classical monocytes
TCACAAGAGCGATCCC.1	CD8+T cell
TCACAAGTCTGTCTCG.1	classical monocytes
TCACGAAAGGGATCTG.1	NK cell
TCACGAATCCTAGAAC.1	CD8+T cell
TCAGATGAGGCATTGG.1	CD4+T cell
TCAGATGTCTCATTCA.1	NK cell
TCAGCAAAGCGACGTA.1	CD8+T cell
TCAGCTCGTACACCGC.1	classical monocytes
TCAGGATCATGCGCAC.1	classical monocytes
TCAGGATTCGCTTAGA.1	CD4+T cell
TCAGGTACAATAGAGT.1	CD4+T cell
TCAGGTACACCGAAAG.1	NK cell
TCAGGTAGTCACCCAG.1	CD8+T cell
TCAGGTAGTGCCTGTG.1	CD4+T cell
TCAGGTAGTTATGCGT.1	CD8+T cell
TCATTACAGACCACGA.1	CD4+T cell
TCATTACAGCGTAGTG.1	NK cell
TCATTACCATACGCTA.1	CD4+T cell
TCATTACCATTGGGCC.1	NK cell
TCATTACTCAGGCAAG.1	CD4+T cell
TCATTTGAGTAACCCT.1	NK cell
TCATTTGGTGGTCCGT.1	NK cell
TCCACACTCTCTTGAT.1	NK cell
TCCCGATAGGTCGGAT.1	classical monocytes
TCCCGATAGTCCCACG.1	CD8+T cell
TCCCGATCACAGACAG.1	CD4+T cell
TCCCGATTCCGAAGAG.1	CD4+T cell
TCCCGATTCGTTTATC.1	CD4+T cell
TCCCGATTCTGCGTAA.1	classical monocytes
TCGAGGCAGAAGGACA.1	CD4+T cell
TCGAGGCCACGACTCG.1	NK cell
TCGAGGCCACTGTGTA.1	NK cell
TCGAGGCCAGATCCAT.1	CD8+T cell
TCGAGGCGTCTAAAGA.1	CD8+T cell
TCGCGAGAGTCAAGCG.1	classical monocytes
TCGCGAGGTAAATGTG.1	CD8+T cell
TCGCGTTTCGTGGACC.1	CD4+T cell
TCGGGACAGAGACGAA.1	NK cell
TCGGGACCATCTCGCT.1	classical monocytes
TCGGTAACAGCGTTCG.1	NK cell
TCGGTAAGTTATTCTC.1	CD4+T cell
TCGGTAATCAGCATGT.1	NK cell
TCGGTAATCATGGTCA.1	CD4+T cell
TCGGTAATCGCCGTGA.1	CD4+T cell
TCGTACCCACGGACAA.1	classical monocytes
TCGTAGAAGGACCACA.1	NK cell
TCTATTGAGAGTCGGT.1	CD4+T cell
TCTATTGGTATTAGCC.1	CD4+T cell
TCTATTGTCTCCCTGA.1	CD8+T cell
TCTCATACATGGTAGG.1	CD4+T cell
TCTCATACATTAACCG.1	CD8+T cell
TCTCATAGTGTTCGAT.1	CD4+T cell
TCTCATATCTAAGCCA.1	CD4+T cell
TCTCTAACAGATCGGA.1	CD4+T cell
TCTGAGACAAGTCATC.1	CD4+T cell
TCTGGAACAGGATCGA.1	NK cell
TCTGGAAGTATCGCAT.1	CD4+T cell
TCTGGAAGTGTTGAGG.1	NK cell
TCTTTCCCAATCGAAA.1	classical monocytes
TCTTTCCTCACCCGAG.1	NK cell
TCTTTCCTCGGTGTTA.1	CD8+T cell
TCTTTCCTCTCAACTT.1	naïve B cells
TGAAAGAGTTCCACGG.1	CD4+T cell
TGAAAGATCAGAGACG.1	CD4+T cell
TGAAAGATCAGTTGAC.1	CD4+T cell
TGACAACCAAGCTGGA.1	CD8+T cell
TGACAACCACAAGCCC.1	NK cell
TGACGGCAGAATAGGG.1	CD4+T cell
TGACGGCTCAATCACG.1	CD4+T cell
TGACTAGCATCACGAT.1	NK cell
TGACTAGTCCCTAACC.1	CD4+T cell
TGACTAGTCTCGCTTG.1	NK cell
TGACTAGTCTTACCTA.1	NK cell
TGACTTTTCATGTGGT.1	classical monocytes
TGACTTTTCCACTCCA.1	NK cell
TGAGAGGCACGTAAGG.1	naïve B cells
TGAGAGGCATGCTAGT.1	CD4+T cell
TGAGCATAGGAGTCTG.1	CD4+T cell
TGAGCATAGGCACATG.1	CD4+T cell
TGAGCATAGTTTGCGT.1	NK cell
TGAGCCGCAACACCCG.1	CD4+T cell
TGAGCCGGTCTCTCGT.1	CD4+T cell
TGAGCCGTCTGAGTGT.1	naïve B cells
TGAGGGACACCAGTTA.1	NK cell
TGAGGGATCCATGAAC.1	classical monocytes
TGATTTCAGGGTTTCT.1	CD4+T cell
TGATTTCTCGGTTAAC.1	naïve B cells
TGCACCTAGACACTAA.1	NK cell
TGCACCTAGCGTAATA.1	CD8+T cell
TGCACCTAGCTCCTCT.1	naïve B cells
TGCACCTCAAAGAATC.1	CD4+T cell
TGCACCTTCAACCAAC.1	CD4+T cell
TGCACCTTCCACTCCA.1	CD4+T cell
TGCACCTTCCTCGCAT.1	NK cell
TGCACCTTCTGCTGTC.1	classical monocytes
TGCCAAATCCCTTGCA.1	NK cell
TGCCCATCACGGTTTA.1	CD4+T cell
TGCCCATCAGCGTCCA.1	CD8+T cell
TGCCCATGTATTCTCT.1	CD8+T cell
TGCCCTATCACTCCTG.1	CD4+T cell
TGCGCAGAGAATTGTG.1	CD4+T cell
TGCGCAGAGTATCTCG.1	NK cell
TGCGCAGTCAGCGACC.1	CD8+T cell
TGCGCAGTCGTTGCCT.1	NK cell
TGCGTGGCACTGTCGG.1	CD8+T cell
TGCGTGGTCCGAAGAG.1	CD4+T cell
TGCTACCCACGCCAGT.1	CD8+T cell
TGCTACCCAGGGTTAG.1	classical monocytes
TGGACGCCATATACCG.1	NK cell
TGGACGCGTCGCGAAA.1	CD8+T cell
TGGCCAGCAGGGAGAG.1	CD8+T cell
TGGCCAGTCTAACGGT.1	NK cell
TGGCGCATCAGCGACC.1	NK cell
TGGCTGGCACGAAATA.1	CD4+T cell
TGGCTGGGTGAGGGAG.1	NK cell
TGGGAAGAGTGAAGAG.1	CD4+T cell
TGGGAAGCAGGCTGAA.1	NK cell
TGGTTAGGTCTTGATG.1	CD4+T cell
TGGTTCCAGGCAAAGA.1	NK cell
TGGTTCCGTCTCTTAT.1	CD8+T cell
TGGTTCCTCAACCATG.1	NK cell
TGTATTCGTCGATTGT.1	naïve B cells
TGTCCCAAGATGTCGG.1	CD4+T cell
TGTCCCACATGGTTGT.1	CD4+T cell
TGTCCCAGTAAAGTCA.1	classical monocytes
TGTCCCAGTTGGTTTG.1	CD8+T cell
TGTCCCAGTTTCCACC.1	CD4+T cell
TGTGTTTCAAAGCAAT.1	CD4+T cell
TGTGTTTCACAGGCCT.1	CD8+T cell
TGTTCCGCAACGATGG.1	CD4+T cell
TGTTCCGCAGCTCGAC.1	CD4+T cell
TGTTCCGCATTGGGCC.1	CD4+T cell
TGTTCCGGTACCATCA.1	CD4+T cell
TTAACTCAGTGAAGAG.1	CD4+T cell
TTAACTCTCATGCAAC.1	CD8+T cell
TTAACTCTCGTAGGTT.1	CD8+T cell
TTAACTCTCTGGTATG.1	CD4+T cell
TTAGGCAAGAGCTTCT.1	CD4+T cell
TTAGGCAGTCTGATTG.1	CD4+T cell
TTAGGCATCTATCGCC.1	NK cell
TTAGTTCTCCTCGCAT.1	CD4+T cell
TTAGTTCTCGTCCGTT.1	CD4+T cell
TTCCCAGGTCTCCACT.1	NK cell
TTCGAAGGTACAGACG.1	NK cell
TTCTACAAGAAGGGTA.1	classical monocytes
TTCTACAAGTGAAGTT.1	CD4+T cell
TTCTACATCTGAAAGA.1	CD4+T cell
TTCTCAAAGACGACGT.1	CD4+T cell
TTCTCAAGTCGCGGTT.1	CD4+T cell
TTCTCCTGTATCAGTC.1	CD8+T cell
TTCTTAGTCTACTATC.1	classical monocytes
TTGAACGCAGGTTTCA.1	CD8+T cell
TTGAACGGTCCGAAGA.1	CD8+T cell
TTGAACGGTGGGTATG.1	naïve B cells
TTGAACGTCGTACCGG.1	CD4+T cell
TTGACTTAGACTGTAA.1	CD8+T cell
TTGACTTAGAGTACCG.1	CD4+T cell
TTGACTTCAGCTGTTA.1	CD4+T cell
TTGACTTTCAGGTTCA.1	CD4+T cell
TTGACTTTCATTCACT.1	CD4+T cell
TTGCCGTGTATGCTTG.1	CD8+T cell
TTGCGTCTCACTCCTG.1	NK cell
TTGGCAACAGGAATGC.1	NK cell
TTGTAGGAGGAGTACC.1	CD4+T cell
TTGTAGGCATGCCTTC.1	naïve B cells
TTGTAGGTCTACTATC.1	CD8+T cell
TTGTAGGTCTGATTCT.1	CD4+T cell
TTTATGCCATCTCGCT.1	NK cell
TTTATGCGTAACGCGA.1	CD4+T cell
TTTATGCTCTATGTGG.1	CD4+T cell
TTTCCTCCACACATGT.1	CD4+T cell
TTTCCTCCATCCGCGA.1	classical monocytes
TTTGCGCGTCATATCG.1	NK cell
TTTGCGCTCTTCCTTC.1	CD4+T cell
TTTGGTTCACCATGTA.1	classical monocytes
TTTGGTTGTCAGAATA.1	CD8+T cell
TTTGGTTTCCACGCAG.1	CD4+T cell
TTTGTCAAGAAACCTA.1	CD8+T cell
TTTGTCACATGAGCGA.1	CD4+T cell
TTTGTCATCATGTCTT.1	CD8+T cell
